PPPWWWPPPPPPPPPPPPPPPPPPPPPPPPPPPPPPPPPPPPPPPPPPPP
PPPWWWWPPPPPPPPPPPPPPPPPPPPPPPPPPPPPPPPPPPPPPPPPPP
PPPWWWWWPPPPPPPPPPWWWWWPPPPFFFFFFFPPPPWWWWWWWWWWWW
PPPWWWWWPPPPPPPPWWWWWWWWPPPFFMMMFFPPPWWWWWWWWWWWWW
PPPPPWWPPPPPPPPPPWWWWWWWWPPFMMMMMFPPWWWWWWWWWWWWWW
PPPPPPPPPPPPPPPPPWWWWWWWWPPFMMMMMFPPWWWWWWWWWWWWWW
PPPPPPPPPPPFFFFFPPWWWWWWWPPFMMMMMFPPWWWWWWWWWWWWWW
PPPPPPPPPPPFFMMFFPPWWWWWWWPFFMMMFFPWWWWWWWWWWWWWWW
PPPPPPPPPPPFFMMMFFPPWWWWWWPPFFFFFPPWWWWWWPPPPWWWWW
PPPPPPPPPPPFFMMMMFPPPWWWWWPPPPPPPPPWWWWWPPPPPPPWWP
PPPPPPPPPPPPFMMMMMFPPPPWWWPPPPPPPPPWWWPPPPPPPPPPPP
PPPPPPPWWPPPFFMMMMFFPPPPWWWPPPPPPPWWWPPPPFFFFPPPPP
PPPPPPWWWWPPPFMMMMFFPPPPWWWWWWWWWWWWPPPPFFFFFFPPPP
PPPPPPWWWWPPPFFMMMFFPPPPWWWWWWWWWWWWPPPFFFFFFFPPPF
PPPPPWWWWPPPPFFFFFFFPPPPWWWWWWWWWWWPPPFFFFFFFPPPPF
WWWWWWWPPPPPPFFFFFPPPPPWWWWWWWWWWWWPPPFFFFFPPPPPPF
WWWWWWPPPPPPPFFFPPPPPPPWWWWWWWWWWWPPPFFFFPPPPPPPPP
WWWWWWPPPPPFFFPPPPPPPPPWWWWWWWWWWWPPPFFFPPPPWWWWPP
PWWWWWPPPPPPPPPPPPPPPPPPPWWWWWWWPPPPFFFPPPPWWWWWPP
PPWWWWPPPPPPPPPPPPPPPPPPPPPPPPPPPPPFFFFPPPWWWWWWWP
PPPWWWPPPPPPPPPPPPPPPPPPPPPPPPPPPPFFFFFPPPWWWWWWWP
PPPPWWWPPPPPPPPPPPPPPPPPPPPPPPPPPFFFFFFPPPWWWWWWWP
FPPPPWWWWWWWWPPPPFFFFFFFFFFFFFFFFFFFFFFPPPWWWWWWPP
MFFPPWWWWWWWWWPPPFFMMMMMMMMMMMMMMMMMFFPPPPPWWWWPPP
MMFPPPWWWWWWWWPPFFMMMMMMMMMMMMMMMMMFFFPPPPPPPPPPPP
MMFFPPWWWWWWWWPPFFMMMMMMMMMMMMMMMMFFFPPPPPPPPPPPPF
MMFFPPWWWWWWWWPPFFMMMMMMMMMMMMMMMFFPPPPPPPPPPPFFFF
MFFFPPPWWWWWWWPPPFFMMMMMMMMMMMMMFFPPPPPPPPPFFFFFFF
FFFPPPPPWWWWWPPPPFFFFFFFFFFFFFFFFPPPPPPPPPFFFFFFFF
PPPPPPPPPPPPPPPPPPPPPPPPPPPPPPPPPPPPWWPPPPFFFFFFPP
PPPPPPPPPPPPPPPPPPPPPPPPPPPPPPPPPPPWWWPPPPFFFFFPPP
PPPPPPPPPPPPPPPPPPPPPPPPPPPPPPPPPWWWWWPPPPFFFFPPPP
PPPPPPPPPPPPPPPPPPPPPPPPPPPWWWWWWWWWWWWPPPPFFPPPPP
WWWWPPPPPPPPPPPPPWWWWWWWWWWWWWWWWWWWWWWPPPPPPPPPPP
WWWWWPPPPPPPPPPPWWWWWWWPPWWWWWWWWWWWWWWWPPPPPPPPPP
WWWWWWPPPPPPPPPWWWWWWPPPPPPWWWWWWWWWWWWWWWWWWWWPPP
PWWWWWWPPPPPPPWWWWWWPPPPPPPPWWWWWWWWWWWWWWWWWWWPPP
PPWWWWWWPPPPPWWWWWWPPPPFFFPPPWWWWWWWWPPPWWWWWWWWPP
PPWWWWWWPPPPPWWWWWWPPPFFFFFPPPWWWWWWPPPPPWWWWWWWPP
PPPWWWWPPPPPPPWWWWPPPPFFMMMFPPPPWWPPPPPPPWWWWWWWPP
PPPWWWPPPPPPPPPWWWPPPPFMMMMMFPPPPPPPPPPPPPWWWWWWWP
PPPWWWPPPPPPPPPPWWPPPPFMMMMMFFPPPPPPFFFFPPPWWWWWWP
PPWWWPPPFFFFFPPPPWPPPPFMMMMMMFPPPPPFFFMFFPPPWWWWWW
PWWWWPPFFMMMFFPPPPPPPPFMMMMMMFPPPPPFFMMMMFPPPWWWWW
PWWWWPPFMMMMMFPPPPPPPPFMMMMMFFPPPPPFFMMMMMFPPPWWWP
WWWWWPPFMMMMMFFPPPPPPPFMMMMMFPPPPPPPFMMMMMMFPPPPPP
WWWWWPPFMMMMMFPPPPPPPPFMMMMFFPPPWWPPFFMMMMMFFPPPPP
WWWWWPPFFMMMFFPPPPPPPPFFMMMFPPPWWWWPPFFMMFFFFFPPPP
PWWWWWPPFFFFFPPPPWPPPPFFMMMFPPPWWWWPPPFFFFFFFFPPPP
PPWWWWPPPPPPPPPPWWPPPPFMMMMFPPPPWWWWPPPPPPPPPPPPPP
