WWWWWWWWWWWWWWWWWWWWWWWWWWW
WPPPPPPPPPPPPPFFFFFFFPPPWWW
WPPPPPPPPPPPPPPFFFFFFPPPWWW
WPPPPPPPPPPPPPPPFFFFPPPPWWW
WPPPPPPPPWWWWWPPPPPPPPPWWWW
WPPPPPPPWWWWWWWWPPPPPPPWWWW
WPPPPPPPPWWWWWWWWPPPPPPWWWW
WPPPPPPPPPWWWWWWWWWPPPWWWPW
WPPFFFFFPPPWWWWWWWWPPPPPPPW
WPFFFFFFFPPPWWWWWWPPPPPPPPW
WPFFFMMMFFPPPPWWWPPPPPPPPFW
WPFFMMMMMFFPPPPPPPPPPPPPFFW
WPFFMMMMMFFFPPPPPPPPFFFFFFW
WPFFMMMMMMFFFPPPPPPFFFFFFFW
WPPFFMMMMMMMFFFPPPPFFFFFFFW
WPPFFMMMMMMMMFFFPPPPPFFFFFW
WPPPFMMMMMMMMMFFPPPPPPFFFFW
WPPPFFMMMMMMMFFFPPPPPPPFFFW
WPPPFFFMMMMMFFFPPPPPPPPPFFW
WPPPFFFFFFFFFFFPPPWWPPPPFFW
WPPFFFFFFFFFFPPPPWWPPPPFFFW
WPFFFFFFFPPPPPPPPPPPPPFFFFW
WFFFFFFFPPPPPPPPPPPPPFFFFMW
WFFFMFFFPPPPPPPPPPPPPFFFMMW
WFFMMFFFPPPPPPWWWPPPPFFFMMW
WFFFFFFFPPPPWWWWWPPPPFFFFMW
WWWWWWWWWWWWWWWWWWWWWWWWWWW
