****************
O777777777777777
OOOOOOOOEEOOOOO7
OOOOOOOOEEOOOOO7
OOOBOOOOOOOOOOO7
OOOOBOOOOONOOOO7
OOOOOOONOOOOOOO7
OOOOOOOONOOOOOO7
OO7OO77OO777OOO7
OOOONOOOOOO7OOO7
OOOOOOOOOOO7OOO7
OOOOOOOOOOO7OOO7
OOOOOOOOOOO7OOO7
OOOOOOOOOOO7OOO7
OOOOOOOOOOOOOOO7
OOOOOOOOOOOOOOO7
OOOOOOOOOOOOOOO7
OOOOOOOOOOOOOOO7
OOOOOOOOOOOOOOO7
OOOOOOOOOOOOOOO7
OO77777OO7777777
