****************
O888888888888888
OCCMOONEEEOOONO8
OCCONOOEEEOOAOO8
ONOBOOOOOOAOCOO8
OCOOBOOCOONOOOM8
OCOCOMONOOONONO8
OCCAOOMONOOOOCO8
OO8OOBBOO888NOO8
OMOONOOOAOOAOOO8
OOCOMOOCOOOAOMO8
OONOOCOOOCOAOOO8
OOCOBOMONOOAOCW8
ONAOOOCOOOOAOOa8
OAAOCOOCOONOCBa8
OOBAOOCOOOCOOOa8
OONOBCMOAOCONOO8
OO8OOCCBB88B8888
