````````````````
````````````````
O777777777777777
OCEEEEE7EEEEEEE7
OCEEEEE7EEEEEEE7
OCEEEEEEEEEEEEE7
OCEEEEEEEEEEEEE7
OCEEEEE7EEEEEEE7
OCEEEEE7EEEEEEE7
OC7EE7777777EEE7
OCEEEEEEEEE7EEE7
OCEEEEEEEEE7EEE7
OCEEEEEEEEE7EEE7
OCEEEEEEEEE7EEE7
OCEEEEEEEEE7EEE7
OCEEEEEEEEEEEEE7
OCEEEEEEEEEEEEE7
OCEEEEEEEEEEEEE7
OCEEEEEEEEEEEEE7
OCEEEEEEEEEEEEE7
OCEEEEEEEEEEEEE7
OC77777777777777
