7777777777777777
7EEEEEE7EEEEEEE7
7EEEEEE7EEEEEEE7
7EEEEEEEEEEEEEE7
7EEEEEEEEEEEEEE7
7EEEEEE7EEEEEEE7
7EEEEEE7EEEEEEE7
777EE7777777EEE7
7EEEEEEEEEE7EEE7
7EEEEEEEEEE7EEE7
7EEEEEEEEEE7EEE7
7EEEEEEEEEE7EEE7
7EEEEEEEEEE7EEE7
7EEEEEEEEEEEEEE7
7EEEEEEEEEEEEEE7
7EEEEEEEEEEEEEE7
7EEEEEEEEEEEEEE7
7EEEEEEEEEEEEEE7
7EEEEEEEEEEEEEE7
7777777777777777
