****************
~~~~~~~~~~~~~~~~
~aCM~~NEEE~~~N~~
~aC~N~~EEE~~A~~~
~N~B~~~~~~A~C~~~
~t~~B~~C~~N~~~M~
~t~C~M~N~~~N~N~~
~nCA~~M~N~~~~C~~
~n~~~BB~~~~~N~~~
~n~~N~~~A~~A~~~~
~nC~M~~C~~~A~M~~
~tN~~C~~~C~A~~~~
~~C~B~M~N~~A~C~~
~tA~~sC~~~~A~~a~
~nA~C~~C~~N~CBa~
~nBA~~C~~~C~~~a~
~nN~BCM~A~C~N~~~
~~~~~CCBB~~B~~~8
