7777777777777777
7BBBBBB7BBBBBBB7
7BBBBBB7BBBBBBB7
7BBBBBBBBBBBBBB7
7BBBBBBBBBBBBBB7
7BBBBBB7BBBBBBB7
7BBBBBB7BBBBBBB7
777BB7777777BBB7
7BBBBBBBBBB7BBB7
7BBBBBBBBBB7BBB7
7BBBBBBBBBB7BBB7
7BBBBBBBBBB7BBB7
7BBBBBBBBBB7BBB7
7BBBBBBBBBBBBBB7
7BBBBBBBBBBBBBB7
7777777777777777
