WWWWWWWWW
WFFFFFFFW
WFFFFFTFW
WFFFFFFFW
WFFFFWWWW
WFFFFFFFW
WFFFFFPFW
WFFFFFFFW
WWWWWWWWW
